all	CHWVTWTGTAYAVDAAANNNG
attB1	CAASTTTGTACAAAAAARNDG
attB2	CHWMTTTGTACAAGAAAKYKG
attB3	CAASTTTGTATAATAAAGTWG
attB4	CMACTTTGTATAGAAAAGTTG
attB5	CMACTTTGTATACAAAAGTTG
attBx	CHWVTTTGTAYAVDAAADNDG
attL1	AAAWWAWKRWTTTWWTTTGACTGATAGTGACCTGTTCGTTGCAACAMATTGATRAGCAATGCTTTTTTATAATGCCAASTTTGTACAAAAAAKHDG
attL2	AAATAATGATTTTATTTTGACTGATAGTGACCTGTTCGTTGCAACAAATTGATAAGCAATGCTTTYTTATAATGCCMACTTTGTACAAGAAABNNG
attL3	AAATAATGATTTTATTTTGACTGATAGTGACCTGTTCGTTGCAACAAATTGATRAGCAATGCTTTTTTATAATGCCAACTWTGTATAATAAAGTTG
attL4	AAATAATGATTTTATTTTGACTGATAGTGACCTGTTCGTTGCAACAAATTGATAAGCAATGCTTTYTTATAATGCCAACTTTGTATAGAAAAGTKG
attL5	AAATAATGATTTTATTTTGACTGATAGTGACCTGTTCGTTGCAACAAATTGATRAGCAATGCTTTYTTATAATGCCAACTTTGTATACAAAAGTTG
attLx	AAAWWAWKRWTTTWWTTTGACTGATAGTGACCTGTTCGTTGCAACAMATTGATRAGCAATGCTTTYTTATAATGCCMASTWTGTAYAVDAAABNNG
attP1	SRAATAATGATTTTATTTTGACTGATAGTGACCTGTTCGTTGCAACAVATTGATRAGCAATGCTTTYTTATAWTGHCAASTTTGTACAAAAAAGYTGAACGAGAAACGTAAAATGATATAAATATCAATATATTAAATTAGATTTTGCATAAAAAACAGACTACATAATACTGTAARACACAACATATSCAGTCV
attP2	BMAATAATGATTTTATTTTGACTGATAGTGACCTGTWCGTYGMAACAAATTGATRAGCAATKMTTTYYTATAATGMCMACTTTGTACAAGAAAGYTGARCGAGAAACGTAARRTGATATAAATATCAATATATTAAATTAGATTTTGCATAAAAAACAGACTACATAATRCTGTAARACACAACATATBCAGTCACTATK
attP3	AAATAATGATTTTATTTYGACTGATAGTGACCTGTTCGTTGCAACAAATTGATRAGCAATGCTTTYYTATAATGCCAACTWTGTATAATAAAGTTGAACGAGAAACGTAAAATGATATAAATATCAATATATTAAATTAGATTTTGCATAAAAAACAGACTACATAATACTGTAAAACACAACATATSCAGTCACTATG
attP4	AAATAATGATTTTATTTTGACTGATAGTGACCTGTTCGTTGCAACAAATTGATAAGCAATGCTTTYTTATAATGCCAACTTTGTATAGAAAAGTTGAACGAGAAACGTAAAATGATATAAATATCAATATATTAAATTAGATTTTGCATAAAAAACAGACTACATAATACTGTAAAACACAACATATSCAGTCACTATG
attP5	MAATAATGATTTTATTTTGACTGATAGTGACCTGTTCGTTGCAACAAATTGATRAGCAATGCTTTYTTATAATGYCAASTTTGTATACAAAAGTTGAACGAGAAACGTAAAATGATATAAATATCAATATATTAAATTAGATTTTGCATAAAAAACAGACTACATAATACTGTAAAACACAACATATSCAGTCACTATG
attPx	VAATAATGATTTTATTTYGACTGATAGTGACCTGTWCGTYGMAACAVATTGATRAGCAATKMTTTYYTATAWTGHCMASTWTGTAYAVDAAAGYTGARCGAGAAACGTAARRTGATATAAATATCAATATATTAAATTAGATTTTGCATAAAAAACAGACTACATAATRCTGTAARACACAACATATBCAGTCV
attR1	CAASTTTGTACAAAAAAGYWGAACGAGAARCGTAAARTGATATAAATATCAATATATTAAATTAGATTTTGCATAAAAAACAGACTACATAATACTGTAAAACACAACATATSCAGTCACTATGAAYCAACTACTTAGATGGTATTAGTGACCTGTA
attR2	CHWVTTTGTACAAGAAAGYTGAACGAGAAACGTAAAATGATATAAATATCAATATATTAAATTAGAYTTTGCATAAAAAACAGACTACATAATACTGTAAAACACAACATATSCAGTCACTATGAAYCAACTACTTAGATGGTATTAGTGACCTGTA
attR3	CAACTTTGTATAATAAAGTTGAACGAGAAACGTAAAATGATATAAATATCAATATATTAAATTAGATTTTGCATAAAAAACAGACTACATAATACTGTAAAACACAACATATSCAGTCACTATGAATCAACTACTTAGATGGTATTAGTGACCTGTA
attR4	CMACTTTGTATAGAAAAGTTGAACGAGAAACGTAAAATGATATAAATATCAATATATTAAATTAGATTTTGCATAAAAAACAGACTACATAATACTGTAAAACACAACATATSCAGTCACTATGAATCAACTACTTAGATGGTATTAGTGACCTGTA
attR5	CMACTTTGTATACAAAAGTTGAACGAGAAACGTAAAATGATATAAATATCAATATATTAAATTAGATTTTGCATAAAAAACAGACTACATAATACTGTAAAACACAACATATCCAGTCACTATGAATCAACTACTTAGATGGTATTAGTGACCTGTA
attRx	CHWVTTTGTAYAVDAAAGYWGAACGAGAARCGTAAARTGATATAAATATCAATATATTAAATTAGAYTTTGCATAAAAAACAGACTACATAATACTGTAAAACACAACATATSCAGTCACTATGAAYCAACTACTTAGATGGTATTAGTGACCTGTA
attX1	CAASTTTGTACAAAAAADNDG
attX2	CHWVTTTGTACAAGAAABNNG
attX3	CAASTWTGTATAATAAAGTWG
attX4	CMACTTTGTATAGAAAAGTKG
attX5	CMASTTTGTATACAAAAGTTG
