all	CHWVTWTGTAYAVDAAANNNG
attB1	CAASTTTGTACAAAAAAKHDG
attB2	CHWVTTTGTACAAGAAABNNG
attB3	CAACTWTGTATAATAAAGTTG
attB4	CMACTTTGTATAGAAAAGTKG
attB5	CMACTTTGTATACAAAAGTTG
attBx	CHWVTWTGTAYAVDAAABNNG
attL1	SRAATAATGATTTTATTTTGACTGATAGTGACCTGTTCGTTGCAACAVATTGATRAGCAATGCTTTYTTATAWTGHCAASTTTGTACAAAAAARNDG
attL2	BMAATAATGATTTTATTTTGACTGATAGTGACCTGTWCGTYGMAACAAATTGATRAGCAATKMTTTYYTATAATGMCMACTTTGTACAAGAAAKYKG
attL3	AAATAATGATTTTATTTYGACTGATAGTGACCTGTTCGTTGCAACAAATTGATRAGCAATGCTTTYYTATAATGCCAACTTTGTATAATAAAGTWG
attL4	AAATAATGATTTTATTTTGACTGATAGTGACCTGTTCGTTGCAACAAATTGATAAGCAATGCTTTYTTATAATGCCAACTTTGTATAGAAAAGTTG
attL5	MAATAATGATTTTATTTTGACTGATAGTGACCTGTTCGTTGCAACAAATTGATRAGCAATGCTTTYTTATAATGYCAASTTTGTATACAAAAGTTG
attLx	VAATAATGATTTTATTTYGACTGATAGTGACCTGTWCGTYGMAACAVATTGATRAGCAATKMTTTYYTATAWTGHCMASTTTGTAYAVDAAADNDG
attP1	AAAWWAWKRWTTTWWTTTGACTGATAGTGACCTGTTCGTTGCAACAMATTGATRAGCAATGCTTTTTTATAATGCCAASTTTGTACAAAAAAGYWGAACGAGAARCGTAAARTGATATAAATATCAATATATTAAATTAGATTTTGCATAAAAAACAGACTACATAATACTGTAAAACACAACATATSCAGTCACTATGAAYCAACTACTTAGATGGTATTAGTGACCTGTA
attP2	AAATAATGATTTTATTTTGACTGATAGTGACCTGTTCGTTGCAACAAATTGATAAGCAATGCTTTYTTATAATGCCMACTTTGTACAAGAAAGYTGAACGAGAAACGTAAAATGATATAAATATCAATATATTAAATTAGAYTTTGCATAAAAAACAGACTACATAATACTGTAAAACACAACATATSCAGTCACTATGAAYCAACTACTTAGATGGTATTAGTGACCTGTA
attP3	AAATAATGATTTTATTTTGACTGATAGTGACCTGTTCGTTGCAACAAATTGATRAGCAATGCTTTTTTATAATGCCAACTTTGTATAATAAAGTTGAACGAGAAACGTAAAATGATATAAATATCAATATATTAAATTAGATTTTGCATAAAAAACAGACTACATAATACTGTAAAACACAACATATSCAGTCACTATGAATCAACTACTTAGATGGTATTAGTGACCTGTA
attP4	AAATAATGATTTTATTTTGACTGATAGTGACCTGTTCGTTGCAACAAATTGATAAGCAATGCTTTYTTATAATGCCAACTTTGTATAGAAAAGTTGAACGAGAAACGTAAAATGATATAAATATCAATATATTAAATTAGATTTTGCATAAAAAACAGACTACATAATACTGTAAAACACAACATATSCAGTCACTATGAATCAACTACTTAGATGGTATTAGTGACCTGTA
attP5	AAATAATGATTTTATTTTGACTGATAGTGACCTGTTCGTTGCAACAAATTGATRAGCAATGCTTTYTTATAATGCCAACTTTGTATACAAAAGTTGAACGAGAAACGTAAAATGATATAAATATCAATATATTAAATTAGATTTTGCATAAAAAACAGACTACATAATACTGTAAAACACAACATATCCAGTCACTATGAATCAACTACTTAGATGGTATTAGTGACCTGTA
attPx	AAAWWAWKRWTTTWWTTTGACTGATAGTGACCTGTTCGTTGCAACAMATTGATRAGCAATGCTTTYTTATAATGCCMASTTTGTAYAVDAAAGYWGAACGAGAARCGTAAARTGATATAAATATCAATATATTAAATTAGAYTTTGCATAAAAAACAGACTACATAATACTGTAAAACACAACATATSCAGTCACTATGAAYCAACTACTTAGATGGTATTAGTGACCTGTA
attR1	CAASTTTGTACAAAAAAGYTGAACGAGAAACGTAAAATGATATAAATATCAATATATTAAATTAGATTTTGCATAAAAAACAGACTACATAATACTGTAARACACAACATATSCAGTCV
attR2	CHWMTTTGTACAAGAAAGYTGARCGAGAAACGTAARRTGATATAAATATCAATATATTAAATTAGATTTTGCATAAAAAACAGACTACATAATRCTGTAARACACAACATATBCAGTCACTATK
attR3	CAASTWTGTATAATAAAGTTGAACGAGAAACGTAAAATGATATAAATATCAATATATTAAATTAGATTTTGCATAAAAAACAGACTACATAATACTGTAAAACACAACATATSCAGTCACTATG
attR4	CMACTTTGTATAGAAAAGTTGAACGAGAAACGTAAAATGATATAAATATCAATATATTAAATTAGATTTTGCATAAAAAACAGACTACATAATACTGTAAAACACAACATATSCAGTCACTATG
attR5	CMACTTTGTATACAAAAGTTGAACGAGAAACGTAAAATGATATAAATATCAATATATTAAATTAGATTTTGCATAAAAAACAGACTACATAATACTGTAAAACACAACATATSCAGTCACTATG
attRx	CHWVTWTGTAYAVDAAAGYTGARCGAGAAACGTAARRTGATATAAATATCAATATATTAAATTAGATTTTGCATAAAAAACAGACTACATAATRCTGTAARACACAACATATBCAGTCV
attX1	CAASTTTGTACAAAAAADNDG
attX2	CHWVTTTGTACAAGAAABNNG
attX3	CAASTWTGTATAATAAAGTWG
attX4	CMACTTTGTATAGAAAAGTKG
attX5	CMASTTTGTATACAAAAGTTG
